######################
#o   K  #K         D@#
#o    .            ###
#o                 -%#
#   %    #K  .     . #
#  .  . # #          #
# X      -#       ## #
#          #         #
#               o   %#
#-    .     .     o  #
#C     .        o    #
#%%%    .     o      #
#CKD       #@#   o  P#
######################