###################
#P     C#T#    DD@#
#   ##   .     ####
#o          ##   +#
#o  ##o           #
#o     .  #   .   #
# . .  . # .    C.#
#C  .  . o  .     #
######            #
#K  @#    T  ##  K#
#TK +#  .   ---  X#
###################