###############
#C   T .#@#  P#
#        #   T#
#-  . ### .  -#
#- .  #C#    -#
#-    #K#    -#
#KT       .  K#
## #          #
#@XD.++     ..#
###############